11111111111111111111111111111111111111111
1P000000000000000000000000000000111000001
11111111111111111111100000000000100010011
11111111111000000000000111111111000000111
11111111111111100000000000000000CCC000111
11100000000000000000000000000CCC00001E111
1111000000CC00000000000000000000011111111
11111111111111111111111111111111111111111
