11111111111
1P000000001
1000CC00001
11110111111
10000000001
100000000E1
11111111111