11111
1P011
1EC01
10011
11111
